1111111111111
1C00C10000C11
11101101111C1
1100000000001
11011111C1111
1C0000P1000E1
1111111111111