1111111111
100P010001
10X0000011
100000E0C1
1111111111