1111111111
1000010001
100X000011
1000P0E0C1
1111111111